{
    "width": 12,
    "height": 12,
    "player1": { "x": 1, "y": 1 },
    "player2": { "x": 10, "y": 10 },
    "goal1": { "x": 10, "y": 1 },
    "goal2": { "x": 1, "y": 10 },
    "walls": [
      { "x": 2, "y": 1 }, { "x": 2, "y": 2 },                         
      { "x": 3, "y": 3 }, { "x": 4, "y": 3 }, { "x": 5, "y": 3 },     
      { "x": 5, "y": 2 }, { "x": 6, "y": 2 },                         
      { "x": 6, "y": 4 }, { "x": 6, "y": 5 }, { "x": 6, "y": 6 },     
      { "x": 5, "y": 6 }, { "x": 4, "y": 6 },                         
      { "x": 7, "y": 7 }, { "x": 8, "y": 7 },                         
      { "x": 9, "y": 6 }, { "x": 9, "y": 5 },                         
      { "x": 10, "y": 4 }, { "x": 10, "y": 3 },                       
      { "x": 8, "y": 9 }, { "x": 7, "y": 9 }, { "x": 6, "y": 9 },     
      { "x": 5, "y": 10 }, { "x": 4, "y": 10 }, { "x": 3, "y": 10 }
    ]
  }